1111111111111111111111111
1000000000000000000000001
1000000000000000000000001
1000000000000000000000001
1000222222220000000000001
1000111111110000000000001
1000222222220000000000001
1000000000000000000000001
1000000000000000000000001
1000000000000000000000001
1000000000000000000000001
1000000000000000000000001
1000000000003000000000001
1000000000000000000000001
1000000000000000000000001
1000000000000000000000001
1000000000000000000000001
1000000000000000000000001
1000000000000222222220001
1000000000000111111110001
1000000000000222222220001
1000000000000000000000001
1000000000000000000000001
1000000000000000000000001
1111111111111111111111111
