1111111111111111111111111
1000000000000000000000001
1000000000000000000000001
1000000000000000000000001
1000111111111111111100001
1000100000000000000000001
1000100000000000000000001
1000200000000000000000001
1000100000000000000000001
1000100000111112111100001
1000100000100000000100001
1000100000203000000100001
1000100000100000000100001
1000100000111111000100001
1000100000000000000100001
1000100000000000000100001
1000100000000000000100001
1000100000000000000100001
1000100000000000000100001
1000111111111111111100001
1000000000000000000000001
1000000000000000000000001
1000000000000000000000001
1000000000000000000000001
1111111111111111111111111

